{
  "width": 8,
  "height": 8,
  "layers": [
    [
      [1, 1, 1, 1, 1, 1, 1, 1],
      [1, 1, 1, 1, 1, 1, 1, 1],
      [1, 1, 1, 1, 1, 1, 1, 1],
      [1, 2, 1, 1, 1, 1, 1, 1],
      [1, 1, 1, 1, 1, 1, 1, 1],
      [1, 1, 1, 1, 1, 1, 1, 1],
      [1, 1, 1, 1, 1, 1, 1, 1],
      [1, 1, 1, 1, 1, 1, 1, 1]
    ],
    [
      [3, 3, 3, 3, 3, 3, 3, 3],
      [3, 0, 0, 0, 0, 0, 0, 3],
      [3, 0, 0, 0, 0, 0, 0, 3],
      [3, 0, 0, 0, 0, 0, 0, 3],
      [3, 0, 0, 0, 0, 0, 0, 3],
      [3, 0, 0, 0, 0, 0, 0, 3],
      [3, 0, 0, 0, 0, 0, 0, 3],
      [3, 3, 3, 3, 3, 3, 3, 3]
    ],
    [
      [0, 0, 0, 0, 0, 0, 0, 0],
      [0, 0, 0, 0, 0, 0, 0, 0],
      [0, 0, 0, 0, 0, 0, 0, 0],
      [0, 0, 4, 0, 0, 0, 0, 0],
      [0, 0, 0, 0, 0, 0, 0, 0],
      [0, 0, 0, 0, 0, 0, 0, 0],
      [0, 0, 0, 0, 0, 0, 0, 0],
      [0, 0, 0, 0, 0, 0, 0, 0]
    ]
  ],
  "objetos": [
    { "id": "chest", "posicao": [2, 2] },
    { "id": "key", "posicao": [4, 4] }
  ]
}
