{
  "width": 8,
  "height": 8,
  "layers": [
    [
      [1, 1, 1, 1, 1, 1, 1, 1],
      [1, 1, 1, 1, 1, 1, 1, 1],
      [1, 1, 1, 1, 1, 1, 1, 1],
      [1, 1, 1, 1, 1, 1, 1, 1],
      [1, 1, 2, 2, 1, 1, 1, 1],
      [1, 1, 1, 1, 1, 1, 1, 1],
      [1, 1, 1, 1, 1, 1, 1, 1],
      [1, 1, 1, 1, 1, 1, 1, 1]
    ],
    [
      [3, 3, 3, 3, 3, 3, 3, 3],
      [3, 0, 0, 0, 0, 0, 0, 3],
      [3, 0, 0, 0, 0, 0, 0, 3],
      [3, 0, 0, 0, 0, 0, 0, 3],
      [3, 0, 0, 0, 0, 0, 0, 3],
      [3, 0, 0, 0, 0, 0, 0, 3],
      [3, 0, 0, 0, 0, 0, 0, 3],
      [3, 3, 3, 3, 3, 3, 3, 3]
    ]
  ],
  "objetos": [
    { "id": "chest", "posicao": [2, 2] },
    { "id": "boots", "posicao": [6, 6] }
  ]
}
