{
  "width": 5,
  "height": 5,
  "layers": [
    [
      [1, 1, 1, 1, 1],
      [1, 1, 1, 1, 1],
      [1, 1, 1, 1, 1],
      [1, 2, 1, 1, 1],
      [1, 1, 1, 1, 1]
    ],
    [
      [0, 0, 0, 0, 0],
      [0, 0, 3, 0, 0],
      [0, 0, 0, 3, 0],
      [0, 0, 3, 0, 0],
      [0, 0, 0, 0, 0]
    ],
    [
      [0, 0, 0, 0, 0],
      [0, 0, 0, 0, 0],
      [0, 0, 4, 0, 0],
      [0, 0, 0, 0, 0],
      [0, 0, 0, 0, 0]
    ]
  ],
  "objetos": [
  ]
}
